0 0 0 0 0 8 1 0 0 0
1 0 -1 0 0 10 0 0 0 0
2 0 -2 0 0 3 0 0 0 0
3 1 -2 0 0 5 0 0 0 0
4 2 -2 0 0 13 0 0 0 0
5 3 -2 0 0 5 0 0 0 0
6 4 -2 0 0 12 0 0 0 0
7 4 -3 0 0 10 0 0 0 0
8 4 -4 0 0 10 0 0 0 0
9 4 -5 0 0 10 0 0 0 0
10 4 -6 0 0 10 0 0 0 0
11 4 -7 0 0 2 2 0 0 0
12 0 0 0 0 8 0 0 0 0
13 0 0 0 0 8 1 0 0 0
14 2 -3 0 0 3 0 0 0 0
15 3 -3 0 0 12 0 0 0 0
16 3 -4 0 0 10 0 0 0 0
17 3 -5 0 0 10 0 0 0 0
18 3 -6 0 0 14 0 0 0 0
19 2 -6 0 0 5 0 0 0 0
20 1 -6 0 0 5 0 0 0 0
21 0 -6 0 0 5 0 0 0 0
22 -1 -6 0 0 5 0 0 0 0
23 -2 -6 0 0 1 0 0 0 0
24 3 -7 0 0 10 0 0 0 0
25 3 -8 0 0 6 0 0 0 0
26 2 -8 0 0 5 0 0 0 0
27 1 -8 0 0 1 0 0 0 0
