0 0 0 0 0 15 0 0 0 0
1 1 0 0 0 15 4 0 0 0
2 1 -1 0 0 6 0 0 0 0
3 0 -1 0 0 15 0 0 0 0
4 -1 -1 0 0 3 0 0 0 0
5 -1 0 0 0 15 0 0 0 0
6 -1 1 0 0 9 0 0 0 0
7 0 1 0 0 15 0 0 0 0
8 1 1 0 0 13 0 0 0 0
9 -2 -2 0 0 12 0 0 0 0
10 -1 -2 0 0 8 0 0 0 0
11 0 -2 0 0 10 0 0 0 0
12 1 -2 0 0 1 0 0 0 0
13 2 -2 0 0 6 0 0 0 0
14 2 -1 0 0 10 0 0 0 0
15 2 0 0 0 15 0 0 0 0
16 2 1 0 0 14 0 0 0 0
17 2 2 0 0 10 0 0 0 0
18 1 2 0 0 2 0 0 0 0
19 0 2 0 0 10 0 0 0 0
20 -1 2 0 0 2 0 0 0 0
21 -2 2 0 0 4 0 0 0 0
22 -2 1 0 0 4 0 0 0 0
23 -2 0 0 0 5 0 0 0 0
24 -2 -1 0 0 4 0 0 0 0
25 0 -3 0 0 14 0 0 0 0
26 0 -4 0 0 7 0 0 0 0
27 -1 -4 0 0 5 0 0 0 0
28 -2 -4 0 0 7 0 0 0 0
29 -3 -4 0 0 5 0 0 0 0
30 -3 0 0 0 5 0 0 0 0
31 3 0 0 0 5 0 0 0 0
32 1 -4 0 0 5 0 0 0 0
33 2 -4 0 0 5 0 0 0 0
34 3 -4 0 0 7 0 0 0 0
35 4 -4 0 0 6 0 0 0 0
36 4 -3 0 0 14 0 0 0 0
37 4 -2 0 0 11 0 0 0 0
38 4 -1 0 0 10 0 0 0 0
39 -4 -3 0 0 10 0 0 0 0
40 -4 -2 0 0 11 0 0 0 0
41 -4 -1 0 0 10 0 0 0 0
42 -4 1 0 0 14 0 0 0 0
43 -4 2 0 0 11 0 0 0 0
44 0 3 0 0 10 0 0 0 0
45 -4 3 0 0 10 0 0 0 0
46 4 1 0 0 10 0 0 0 0
47 4 2 0 0 10 0 0 0 0
48 4 3 0 0 11 0 0 0 0
49 3 4 0 0 5 0 0 0 0
50 2 4 0 0 13 0 0 0 0
51 1 4 0 0 5 4 0 0 0
52 -1 4 0 0 5 0 0 0 0
53 -2 4 0 0 5 0 0 0 0
54 -3 4 0 0 5 0 0 0 0
55 -4 4 0 0 9 0 0 0 0
56 0 4 0 0 15 0 0 0 0
57 4 4 0 0 12 0 0 0 0
58 -4 0 0 0 11 0 0 0 0
59 4 0 0 0 15 0 0 0 0
60 -4 -4 0 0 3 0 0 0 0
61 3 -3 0 0 9 0 0 0 0
62 -3 -2 0 0 5 0 0 0 0
63 -2 -3 0 0 10 0 0 0 0
64 -3 2 0 0 5 0 0 0 0
65 2 3 0 0 10 0 0 0 0
66 5 0 0 0 5 0 0 0 0
67 6 0 0 0 12 0 0 0 0
68 6 -1 0 0 11 0 0 0 0
69 7 -1 0 0 5 0 0 0 0
70 6 -2 0 0 14 0 0 0 0
71 5 -2 0 0 5 0 0 0 0
72 -1 -3 0 0 3 0 0 0 0
73 0 5 0 0 12 0 0 0 0
74 -1 5 0 0 5 0 0 0 0
75 -2 5 0 0 1 1 0 0 0
76 6 -3 0 0 3 0 0 0 0
77 7 -3 0 0 13 0 0 0 0
78 7 -4 0 0 6 0 0 0 0
79 6 -4 0 0 5 0 0 0 0
80 5 -4 0 0 9 0 0 0 0
81 5 -5 0 0 6 0 0 0 0
82 4 -5 0 0 5 0 0 0 0
83 8 -3 0 0 7 0 0 0 0
84 8 -2 0 0 9 0 0 0 0
85 9 -3 0 0 5 0 0 0 0
86 9 -2 0 0 5 0 0 0 0
87 3 -5 0 0 13 0 0 0 0
88 3 -6 0 0 3 0 0 0 0
89 4 -6 0 0 5 0 0 0 0
90 2 -5 0 0 5 0 0 0 0
91 1 -5 0 0 5 0 0 0 0
92 0 -5 0 0 5 0 0 0 0
93 5 -6 0 0 12 0 0 0 0
94 5 -7 0 0 10 0 0 0 0
95 10 -3 0 0 6 0 0 0 0
96 10 -2 0 0 13 0 0 0 0
97 5 -8 0 0 10 0 0 0 0
98 5 -9 0 0 10 0 0 0 0
99 5 -10 0 0 10 0 0 0 0
100 5 -11 0 0 2 2 0 0 0
101 -1 -5 0 0 13 0 0 0 0
102 -2 -5 0 0 5 0 0 0 0
103 -3 -5 0 0 13 0 0 0 0
104 -4 -5 0 0 5 0 0 0 0
105 -5 -5 0 0 3 0 0 0 0
106 -5 -4 0 0 10 0 0 0 0
107 -5 1 0 0 9 0 0 0 0
108 -5 0 0 0 10 4 0 0 0
109 -5 -1 0 0 10 0 0 0 0
110 -5 -2 0 0 10 0 0 0 0
111 -5 -3 0 0 10 0 0 0 0
112 8 -1 0 0 5 0 0 0 0
113 9 -1 0 0 6 0 0 0 0
114 9 0 0 0 15 0 0 0 0
115 9 1 0 0 12 4 0 0 0
116 8 1 0 0 7 0 0 0 0
117 7 1 0 0 9 0 0 0 0
118 7 0 0 0 3 0 0 0 0
119 8 0 0 0 5 0 0 0 0
120 5 3 0 0 5 0 0 0 0
121 6 3 0 0 5 0 0 0 0
122 7 3 0 0 5 0 0 0 0
123 8 3 0 0 12 0 0 0 0
124 8 2 0 0 10 0 0 0 0
125 10 0 0 0 5 0 0 0 0
126 11 -2 0 0 6 0 0 0 0
127 11 -1 0 0 10 0 0 0 0
128 11 0 0 0 12 0 0 0 0
129 -3 -6 0 0 3 0 0 0 0
130 -2 -6 0 0 4 4 0 0 0
131 -1 -6 0 0 10 0 0 0 0
132 -1 -7 0 0 6 0 0 0 0
133 -2 -7 0 0 5 0 0 0 0
134 -3 -7 0 0 1 0 0 0 0
135 -1 1 0 1 8 1 0 0 0
136 0 0 0 1 12 0 0 0 0
137 1 -1 0 1 4 2 0 0 0
138 0 -1 0 1 3 0 0 0 0
139 -1 0 0 1 3 0 0 0 0
