0 0 0 0 0 15 0 0 0 0
1 1 0 0 0 15 4 0 0 0
2 1 -1 0 0 6 0 0 0 0
3 0 -1 0 0 15 0 0 0 0
4 -1 -1 0 0 3 0 0 0 0
5 -1 0 0 0 15 0 0 0 0
6 -1 1 0 0 9 0 0 0 0
7 0 1 0 0 15 0 0 0 0
8 1 1 0 0 13 0 0 0 0
9 -2 -2 0 0 12 0 0 0 0
10 -1 -2 0 0 8 0 0 0 0
11 0 -2 0 0 10 0 0 0 0
12 1 -2 0 0 1 0 0 0 0
13 2 -2 0 0 6 0 0 0 0
14 2 -1 0 0 10 0 0 0 0
15 2 0 0 0 15 0 0 0 0
16 2 1 0 0 14 0 0 0 0
17 2 2 0 0 10 0 0 0 0
18 1 2 0 0 2 0 0 0 0
19 0 2 0 0 10 0 0 0 0
20 -1 2 0 0 2 0 0 0 0
21 -2 2 0 0 4 0 0 0 0
22 -2 1 0 0 4 0 0 0 0
23 -2 0 0 0 5 0 0 0 0
24 -2 -1 0 0 4 0 0 0 0
25 0 -3 0 0 14 0 0 0 0
26 0 -4 0 0 7 0 0 0 0
27 -1 -4 0 0 5 0 0 0 0
28 -2 -4 0 0 7 0 0 0 0
29 -3 -4 0 0 5 0 0 0 0
30 -3 0 0 0 5 0 0 0 0
31 3 0 0 0 5 0 0 0 0
32 1 -4 0 0 5 0 0 0 0
33 2 -4 0 0 5 0 0 0 0
34 3 -4 0 0 7 0 0 0 0
35 4 -4 0 0 6 0 0 0 0
36 4 -3 0 0 14 0 0 0 0
37 4 -2 0 0 11 0 0 0 0
38 4 -1 0 0 10 0 0 0 0
39 -4 -3 0 0 10 0 0 0 0
40 -4 -2 0 0 11 0 0 0 0
41 -4 -1 0 0 10 0 0 0 0
42 -4 1 0 0 14 0 0 0 0
43 -4 2 0 0 11 0 0 0 0
44 0 3 0 0 10 0 0 0 0
45 -4 3 0 0 10 0 0 0 0
46 4 1 0 0 10 0 0 0 0
47 4 2 0 0 10 0 0 0 0
48 4 3 0 0 11 0 0 0 0
49 3 4 0 0 5 0 0 0 0
50 2 4 0 0 13 0 0 0 0
51 1 4 0 0 5 4 0 0 0
52 -1 4 0 0 5 0 0 0 0
53 -2 4 0 0 5 0 0 0 0
54 -3 4 0 0 5 0 0 0 0
55 -4 4 0 0 9 0 0 0 0
56 0 4 0 0 15 0 0 0 0
57 4 4 0 0 12 0 0 0 0
58 -4 0 0 0 11 0 0 0 0
59 4 0 0 0 15 0 0 0 0
60 -4 -4 0 0 3 0 0 0 0
61 3 -3 0 0 9 0 0 0 0
62 -3 -2 0 0 5 0 0 0 0
63 -2 -3 0 0 10 0 0 0 0
64 -3 2 0 0 5 0 0 0 0
65 2 3 0 0 10 0 0 0 0
66 5 0 0 0 5 0 0 0 0
67 6 0 0 0 12 0 0 0 0
68 6 -1 0 0 11 0 0 0 0
69 7 -1 0 0 5 0 0 0 0
70 6 -2 0 0 14 0 0 0 0
71 5 -2 0 0 5 0 0 0 0
72 -1 -3 0 0 3 0 0 0 0
73 0 5 0 0 12 0 0 0 0
74 -1 5 0 0 5 0 0 0 0
75 -2 5 0 0 1 1 0 0 0
76 6 -3 0 0 3 0 0 0 0
77 7 -3 0 0 13 0 0 0 0
78 7 -4 0 0 6 0 0 0 0
79 6 -4 0 0 5 0 0 0 0
80 5 -4 0 0 9 0 0 0 0
81 5 -5 0 0 6 0 0 0 0
82 4 -5 0 0 5 0 0 0 0
83 8 -3 0 0 7 0 0 0 0
84 8 -2 0 0 9 0 0 0 0
85 9 -3 0 0 5 0 0 0 0
86 9 -2 0 0 5 0 0 0 0
87 3 -5 0 0 13 0 0 0 0
88 3 -6 0 0 3 0 0 0 0
89 4 -6 0 0 5 0 0 0 0
90 2 -5 0 0 5 0 0 0 0
91 1 -5 0 0 5 0 0 0 0
92 0 -5 0 0 5 0 0 0 0
93 5 -6 0 0 12 0 0 0 0
94 5 -7 0 0 10 0 0 0 0
95 10 -3 0 0 6 0 0 0 0
96 10 -2 0 0 13 0 0 0 0
97 5 -8 0 0 10 0 0 0 0
98 5 -9 0 0 10 0 0 0 0
99 5 -10 0 0 10 0 0 0 0
100 5 -11 0 0 2 2 0 0 0
101 -1 -5 0 0 13 0 0 0 0
102 -2 -5 0 0 5 0 0 0 0
103 -3 -5 0 0 13 0 0 0 0
104 -4 -5 0 0 5 0 0 0 0
105 -5 -5 0 0 3 0 0 0 0
106 -5 -4 0 0 10 0 0 0 0
107 -5 1 0 0 9 0 0 0 0
108 -5 0 0 0 10 4 0 0 0
109 -5 -1 0 0 10 0 0 0 0
110 -5 -2 0 0 10 0 0 0 0
111 -5 -3 0 0 10 0 0 0 0
112 8 -1 0 0 5 0 0 0 0
113 9 -1 0 0 6 0 0 0 0
114 9 0 0 0 15 0 0 0 0
115 9 1 0 0 12 4 0 0 0
116 8 1 0 0 7 0 0 0 0
117 7 1 0 0 9 0 0 0 0
118 7 0 0 0 3 0 0 0 0
119 8 0 0 0 5 0 0 0 0
120 5 3 0 0 5 0 0 0 0
121 6 3 0 0 5 0 0 0 0
122 7 3 0 0 5 0 0 0 0
123 8 3 0 0 12 0 0 0 0
124 8 2 0 0 10 0 0 0 0
125 10 0 0 0 5 0 0 0 0
126 11 -2 0 0 6 0 0 0 0
127 11 -1 0 0 10 0 0 0 0
128 11 0 0 0 12 0 0 0 0
129 -3 -6 0 0 3 0 0 0 0
130 -2 -6 0 0 4 4 0 0 0
131 -1 -6 0 0 10 0 0 0 0
132 -1 -7 0 0 6 0 0 0 0
133 -2 -7 0 0 5 0 0 0 0
134 -3 -7 0 0 1 0 0 0 0
135 -1 1 0 1 8 1 0 0 0
136 0 0 0 1 12 0 0 0 0
137 1 -1 0 1 4 2 0 0 0
138 0 -1 0 1 3 0 0 0 0
139 -1 0 0 1 3 0 0 0 0
140 -5 2 0 2 8 0 0 0 0
141 -4 2 0 2 9 0 0 0 0
142 -3 2 0 2 4 4 0 0 0
143 -2 2 0 2 9 0 0 0 0
144 -1 2 0 2 13 0 0 0 0
145 0 2 0 2 4 0 0 0 0
146 1 2 0 2 8 0 0 0 0
147 2 2 0 2 8 0 0 0 0
148 3 2 0 2 9 0 0 0 0
149 4 2 0 2 12 4 0 0 0
150 -5 1 0 2 10 0 0 0 0
151 -4 1 0 2 11 0 0 0 0
152 -3 1 0 2 5 0 0 0 0
153 -2 1 0 2 6 0 0 0 0
154 -1 1 0 2 3 0 0 0 0
155 0 1 0 2 5 0 0 0 0
156 1 1 0 2 14 0 0 0 0
157 2 1 0 2 10 0 0 0 0
158 3 1 0 2 10 0 0 0 0
159 4 1 0 2 10 0 0 0 0
160 -5 0 0 2 10 0 0 0 0
161 -4 0 0 2 3 0 0 0 0
162 -3 0 0 2 5 0 0 0 0
163 -2 0 0 2 5 0 0 0 0
164 -1 0 0 2 5 0 0 0 0
165 0 0 0 2 12 0 0 0 0
166 1 0 0 2 10 0 0 0 0
167 2 0 0 2 10 0 0 0 0
168 3 0 0 2 10 0 0 0 0
169 4 0 0 2 10 0 0 0 0
170 -5 -1 2 0 11 0 0 0 0
171 -4 -1 2 0 13 0 0 0 0
172 -3 -1 2 0 5 0 0 0 0
173 -2 -1 2 0 5 0 0 0 0
174 -1 -1 2 0 5 0 0 0 0
175 0 -1 0 2 14 0 0 0 0
176 1 -1 0 2 10 0 0 0 0
177 2 -1 0 2 10 0 0 0 0
178 3 -1 0 2 10 0 0 0 0
179 4 -1 0 2 10 0 0 0 0
180 -5 -2 0 2 10 0 0 0 0
181 -4 -2 0 2 10 0 0 0 0
182 -3 -2 0 2 1 4 0 0 0
183 -2 -2 0 2 5 0 0 0 0
184 -1 -2 0 2 5 0 0 0 0
185 0 -2 0 2 6 0 0 0 0
186 1 -2 0 2 11 0 0 0 0
187 2 -2 0 2 7 0 0 0 0
188 3 -2 0 2 14 0 0 0 0
189 4 -2 0 2 10 0 0 0 0
190 -5 -3 0 2 2 0 0 0 0
191 -4 -3 0 2 11 0 0 0 0
192 -3 -3 0 2 5 0 0 0 0
193 -2 -3 0 2 5 0 0 0 0
194 -1 -3 0 2 5 0 0 0 0
195 0 -3 0 2 4 0 0 0 0
196 1 -3 0 2 3 0 0 0 0
197 2 -3 0 2 12 0 0 0 0
198 3 -3 0 2 10 0 0 0 0
199 4 -3 0 2 10 0 0 0 0
200 -5 -4 0 2 1 2 0 0 0
201 -4 -4 0 2 7 0 0 0 0
202 -3 -4 0 2 13 0 0 0 0
203 -2 -4 0 2 13 0 0 0 0
204 -1 -4 0 2 5 0 0 0 0
205 0 -4 0 2 12 0 0 0 0
206 1 -4 0 2 8 0 0 0 0
207 2 -4 0 2 10 0 0 0 0
208 3 -4 0 2 10 0 0 0 0
209 4 -4 0 2 10 0 0 0 0
210 -5 -5 0 2 9 0 0 0 0
211 -4 -5 0 2 5 0 0 0 0
212 -3 -5 0 2 6 0 0 0 0
213 -2 -5 0 2 3 0 0 0 0
214 -1 -5 0 2 5 0 0 0 0
215 0 -5 0 2 7 0 0 0 0
216 1 -5 0 2 14 0 0 0 0
217 2 -5 0 2 10 0 0 0 0
218 3 -5 0 2 10 0 0 0 0
219 4 -5 0 2 10 0 0 0 0
220 -5 -6 0 2 10 0 0 0 0
221 -4 -6 0 2 1 0 0 0 0
222 -3 -6 0 2 5 0 0 0 0
223 -2 -6 0 2 5 0 0 0 0
224 -1 -6 0 2 12 0 0 0 0
225 0 -6 0 2 1 4 0 0 0
226 1 -6 0 2 6 0 0 0 0
227 2 -6 0 2 10 0 0 0 0
228 3 -6 0 2 10 0 0 0 0
229 4 -6 0 2 10 0 0 0 0
230 -5 -7 0 2 3 0 0 0 0
231 -4 -7 0 2 12 0 0 0 0
232 -3 -7 0 2 9 0 0 0 0
233 -2 -7 0 2 12 0 0 0 0
234 -1 -7 0 2 3 0 0 0 0
235 0 -7 0 2 5 0 0 0 0
236 1 -7 0 2 5 0 0 0 0
237 2 -7 0 2 6 0 0 0 0
238 3 -7 0 2 2 1 0 0 0
239 4 -7 0 2 10 0 0 0 0
240 -5 -8 0 2 9 0 0 0 0
241 -4 -8 0 2 6 4 0 0 0
242 -3 -8 0 2 10 0 0 0 0
243 -2 -8 0 2 3 0 0 0 0
244 -1 -8 0 2 5 0 0 0 0
245 0 -8 0 2 5 0 0 0 0
246 1 -8 0 2 4 0 0 0 0
247 2 -8 0 2 9 0 0 0 0
248 3 -8 0 2 12 0 0 0 0
249 4 -8 0 2 10 0 0 0 0
250 -5 -9 0 2 3 0 0 0 0
251 -4 -9 0 2 5 0 0 0 0
252 -3 -9 0 2 7 0 0 0 0
253 -2 -9 0 2 5 0 0 0 0
254 -1 -9 0 2 5 0 0 0 0
255 0 -9 0 2 5 0 0 0 0
256 1 -9 0 2 5 0 0 0 0
257 2 -9 0 2 6 0 0 0 0
258 3 -9 0 2 3 0 0 0 0
259 4 -9 0 2 6 0 0 0 0
260 -5 -1 0 2 11 0 0 0 0
261 -4 -1 0 2 13 0 0 0 0
262 -3 -1 0 2 5 0 0 0 0
263 -2 -1 0 2 5 0 0 0 0
264 -1 -1 0 2 5 0 0 0 0
