0 0 0 0 0 15 0 0 0 0
1 1 0 0 0 15 4 0 0 0
2 1 -1 0 0 6 0 0 0 0
3 0 -1 0 0 15 0 0 0 0
4 -1 -1 0 0 3 0 0 0 0
5 -1 0 0 0 15 0 0 0 0
6 -1 1 0 0 9 0 0 0 0
7 0 1 0 0 15 0 0 0 0
8 1 1 0 0 13 0 0 0 0
9 -2 -2 0 0 12 0 0 0 0
10 -1 -2 0 0 8 0 0 0 0
11 0 -2 0 0 10 0 0 0 0
12 1 -2 0 0 1 0 0 0 0
13 2 -2 0 0 6 0 0 0 0
14 2 -1 0 0 10 0 0 0 0
15 2 0 0 0 15 0 0 0 0
16 2 1 0 0 14 0 0 0 0
17 2 2 0 0 10 0 0 0 0
19 0 2 0 0 10 0 1 134 0
21 -2 2 0 0 4 0 0 0 0
23 -2 0 0 0 5 0 0 0 0
25 0 -3 0 0 14 0 0 0 0
26 0 -4 0 0 7 0 0 0 0
27 -1 -4 0 0 5 0 0 0 0
28 -2 -4 0 0 7 0 0 0 0
29 -3 -4 0 0 5 0 0 0 0
30 -3 0 0 0 5 0 0 0 0
31 3 0 0 0 5 0 0 0 0
32 1 -4 0 0 5 0 0 0 0
33 2 -4 0 0 5 0 0 0 0
34 3 -4 0 0 7 0 0 0 0
35 4 -4 0 0 6 0 0 0 0
36 4 -3 0 0 14 0 0 0 0
37 4 -2 0 0 11 0 0 0 0
38 4 -1 0 0 10 0 0 0 0
39 -4 -3 0 0 10 0 0 0 0
40 -4 -2 0 0 11 0 0 0 0
41 -4 -1 0 0 10 0 0 0 0
42 -4 1 0 0 14 0 0 0 0
43 -4 2 0 0 11 0 0 0 0
44 0 3 0 0 10 0 0 0 0
45 -4 3 0 0 10 0 0 0 0
46 4 1 0 0 10 0 0 0 0
47 4 2 0 0 10 0 0 0 0
48 4 3 0 0 11 0 0 0 0
49 3 4 0 0 5 0 0 0 0
50 2 4 0 0 13 0 0 0 0
51 1 4 0 0 5 4 0 0 0
52 -1 4 0 0 5 0 0 0 0
53 -2 4 0 0 5 0 0 0 0
54 -3 4 0 0 7 0 0 0 0
55 -4 4 0 0 9 0 0 0 0
56 0 4 0 0 15 0 0 0 0
57 4 4 0 0 12 0 0 0 0
58 -4 0 0 0 11 0 0 0 0
59 4 0 0 0 15 0 0 0 0
60 -4 -4 0 0 3 0 0 0 0
61 3 -3 0 0 9 0 0 0 0
62 -3 -2 0 0 5 0 0 0 0
63 -2 -3 0 0 10 0 0 0 0
64 -3 2 0 0 5 0 0 0 0
65 2 3 0 0 10 0 0 0 0
66 5 0 0 0 5 0 0 0 0
67 6 0 0 0 12 0 0 0 0
68 6 -1 0 0 11 0 0 0 0
69 7 -1 0 0 5 0 0 0 0
70 6 -2 0 0 14 0 0 0 0
71 5 -2 0 0 5 0 0 0 0
72 -1 -3 0 0 3 0 0 0 0
73 0 5 0 0 12 0 0 0 0
74 -1 5 0 0 5 0 0 0 0
75 -2 5 0 0 5 1 0 0 0
76 6 -3 0 0 3 0 0 0 0
77 7 -3 0 0 13 0 0 0 0
78 7 -4 0 0 6 0 0 0 0
79 6 -4 0 0 5 0 0 0 0
80 5 -4 0 0 9 0 0 0 0
81 5 -5 0 0 6 0 0 0 0
82 4 -5 0 0 5 0 0 0 0
83 8 -3 0 0 7 0 0 0 0
84 8 -2 0 0 9 0 0 0 0
85 9 -3 0 0 5 0 0 0 0
86 9 -2 0 0 5 0 0 0 0
87 3 -5 0 0 13 0 0 0 0
88 3 -6 0 0 3 0 0 0 0
89 4 -6 0 0 5 0 0 0 0
90 2 -5 0 0 5 0 0 0 0
91 1 -5 0 0 5 0 0 0 0
92 0 -5 0 0 5 0 0 0 0
93 5 -6 0 0 12 0 0 0 0
94 5 -7 0 0 10 0 0 0 0
95 10 -3 0 0 6 0 0 0 0
96 10 -2 0 0 13 0 0 0 0
97 5 -8 0 0 10 0 0 0 0
98 5 -9 0 0 10 0 0 0 0
99 5 -10 0 0 10 0 0 0 0
100 5 -11 0 0 2 2 0 0 0
101 -1 -5 0 0 13 0 0 0 0
102 -2 -5 0 0 5 0 0 0 0
103 -3 -5 0 0 13 0 0 0 0
104 -4 -5 0 0 5 0 0 0 0
105 -5 -5 0 0 3 0 0 0 0
106 -5 -4 0 0 10 0 0 0 0
107 -5 1 0 0 9 0 0 0 0
108 -5 0 0 0 10 4 0 0 0
109 -5 -1 0 0 10 0 0 0 0
110 -5 -2 0 0 10 0 0 0 0
111 -5 -3 0 0 10 0 0 0 0
112 8 -1 0 0 5 0 0 0 0
113 9 -1 0 0 6 0 0 0 0
114 9 0 0 0 15 0 0 0 0
115 9 1 0 0 12 4 0 0 0
116 8 1 0 0 7 0 0 0 0
117 7 1 0 0 9 0 0 0 0
118 7 0 0 0 3 0 0 0 0
119 8 0 0 0 5 0 0 0 0
120 5 3 0 0 5 0 0 0 0
121 6 3 0 0 5 0 0 0 0
122 7 3 0 0 5 0 0 0 0
123 8 3 0 0 12 0 0 0 0
124 8 2 0 0 10 0 0 0 0
125 10 0 0 0 5 0 0 0 0
126 11 -2 0 0 6 0 0 0 0
127 11 -1 0 0 10 0 0 0 0
128 11 0 0 0 12 0 0 0 0
129 -3 -6 0 0 3 0 0 0 0
130 -2 -6 0 0 4 4 0 0 0
131 -1 -6 0 0 10 0 0 0 0
132 -1 -7 0 0 6 0 0 0 0
133 -2 -7 0 0 5 0 0 0 0
134 -3 -7 0 0 1 0 0 0 0
135 -5 2 0 1 9 0 0 0 0
136 -4 2 0 1 13 0 0 0 0
137 -3 2 0 1 4 4 0 0 0
138 -2 2 0 1 9 0 0 0 0
139 -1 2 0 1 13 0 0 0 0
140 0 2 0 1 12 0 0 0 0
141 1 2 0 1 9 0 0 0 0
142 2 2 0 1 12 0 0 0 0
143 3 2 0 1 9 0 0 0 0
144 4 2 0 1 12 4 0 0 0
145 -5 1 0 1 10 0 0 0 0
146 -4 1 0 1 11 0 0 0 0
147 -3 1 0 1 5 0 0 0 0
148 -2 1 0 1 6 0 0 0 0
149 -1 1 0 1 3 0 0 0 0
150 0 1 0 1 7 0 0 0 0
151 1 1 0 1 14 0 0 0 0
152 2 1 0 1 11 0 0 0 0
153 3 1 0 1 14 0 0 0 0
154 4 1 0 1 10 0 0 0 0
155 -5 0 0 1 10 0 0 0 0
156 -4 0 0 1 3 0 0 0 0
157 -3 0 0 1 5 0 0 0 0
158 -2 0 0 1 5 0 0 0 0
159 -1 0 0 1 5 0 0 0 0
160 0 0 0 1 12 0 0 0 0
161 1 0 0 1 10 0 0 0 0
162 2 0 0 1 10 0 0 0 0
163 3 0 0 1 10 0 0 0 0
164 4 0 0 1 10 0 0 0 0
165 -5 -1 2 1 11 0 0 0 0
166 -4 -1 2 1 13 0 0 0 0
167 -3 -1 2 1 5 0 0 0 0
168 -2 -1 2 1 5 0 0 0 0
169 -1 -1 2 1 5 0 0 0 0
170 0 -1 0 1 14 0 0 0 0
171 1 -1 0 1 10 0 0 0 0
172 2 -1 0 1 10 0 0 0 0
173 3 -1 0 1 10 0 0 0 0
174 4 -1 0 1 10 0 0 0 0
175 -5 -2 0 1 10 0 0 0 0
176 -4 -2 0 1 10 0 0 0 0
177 -3 -2 0 1 1 4 0 0 0
178 -2 -2 0 1 5 0 0 0 0
179 -1 -2 0 1 13 0 0 0 0
180 0 -2 0 1 6 0 0 0 0
181 1 -2 0 1 11 0 0 0 0
182 2 -2 0 1 7 0 0 0 0
183 3 -2 0 1 14 0 0 0 0
184 4 -2 0 1 10 0 0 0 0
185 -5 -3 0 1 2 0 0 0 0
186 -4 -3 0 1 11 0 0 0 0
187 -3 -3 0 1 5 0 0 0 0
188 -2 -3 0 1 5 0 0 0 0
189 -1 -3 0 1 7 0 0 0 0
190 0 -3 0 1 12 0 0 0 0
191 1 -3 0 1 3 0 0 0 0
192 2 -3 0 1 12 0 0 0 0
193 3 -3 0 1 10 0 0 0 0
194 4 -3 0 1 10 0 0 0 0
195 -5 -4 0 1 1 2 0 0 0
196 -4 -4 0 1 7 0 0 0 0
197 -3 -4 0 1 13 0 0 0 0
198 -2 -4 0 1 13 0 0 0 0
199 -1 -4 0 1 5 0 0 0 0
200 0 -4 0 1 6 0 0 0 0
201 1 -4 0 1 9 0 0 0 0
202 2 -4 0 1 14 0 0 0 0
203 3 -4 0 1 11 0 0 0 0
204 4 -4 0 1 14 0 0 0 0
205 -5 -5 0 1 9 0 0 0 0
206 -4 -5 0 1 5 0 0 0 0
207 -3 -5 0 1 6 0 0 0 0
208 -2 -5 0 1 3 0 0 0 0
209 -1 -5 0 1 5 0 0 0 0
210 0 -5 0 1 5 0 0 0 0
211 1 -5 0 1 14 0 0 0 0
212 2 -5 0 1 11 0 0 0 0
213 3 -5 0 1 14 0 0 0 0
214 4 -5 0 1 10 0 0 0 0
215 -5 -6 0 1 10 0 0 0 0
216 -4 -6 0 1 1 0 0 0 0
217 -3 -6 0 1 5 0 0 0 0
218 -2 -6 0 1 5 0 0 0 0
219 -1 -6 0 1 12 0 0 0 0
220 0 -6 0 1 1 4 0 0 0
221 1 -6 0 1 14 0 0 0 0
222 2 -6 0 1 10 0 0 0 0
223 3 -6 0 1 10 0 0 0 0
224 4 -6 0 1 10 0 0 0 0
225 -5 -7 0 1 3 0 0 0 0
226 -4 -7 0 1 12 0 0 0 0
227 -3 -7 0 1 9 0 0 0 0
228 -2 -7 0 1 12 0 0 0 0
229 -1 -7 0 1 3 0 0 0 0
230 0 -7 0 1 5 0 0 0 0
231 1 -7 0 1 7 0 0 0 0
232 2 -7 0 1 6 0 0 0 0
233 3 -7 0 1 2 1 0 0 0
234 4 -7 0 1 10 0 0 0 0
235 -5 -8 0 1 9 0 0 0 0
236 -4 -8 0 1 6 4 0 0 0
237 -3 -8 0 1 10 0 0 0 0
238 -2 -8 0 1 3 0 0 0 0
239 -1 -8 0 1 5 0 0 0 0
240 0 -8 0 1 5 0 0 0 0
241 1 -8 0 1 4 0 0 0 0
242 2 -8 0 1 9 0 0 0 0
243 3 -8 0 1 12 0 0 0 0
244 4 -8 0 1 10 0 0 0 0
245 -5 -9 0 1 3 0 0 0 0
246 -4 -9 0 1 5 0 0 0 0
247 -3 -9 0 1 7 0 0 0 0
248 -2 -9 0 1 5 0 0 0 0
249 -1 -9 0 1 5 0 0 0 0
250 0 -9 0 1 5 0 0 0 0
251 1 -9 0 1 5 0 0 0 0
252 2 -9 0 1 6 0 0 0 0
253 3 -9 0 1 3 0 0 0 0
254 4 -9 0 1 6 0 0 0 0
255 -5 -1 0 1 11 0 0 0 0
256 -4 -1 0 1 13 0 0 0 0
257 -3 -1 0 1 5 0 0 0 0
258 -2 -1 0 1 5 0 0 0 0
259 -1 -1 0 1 5 0 0 0 0
260 -5 8 0 2 3 1 0 0 0
261 -5 9 0 2 9 0 0 0 0
262 -4 8 0 2 15 0 0 0 0
263 -4 9 0 2 12 0 0 0 0
264 -3 8 0 2 5 0 0 0 0
265 -2 8 0 2 12 0 0 0 0
266 -4 7 0 2 10 0 0 0 0
267 -2 7 0 2 10 0 0 0 0
268 -3 6 0 2 13 0 0 0 0
269 -4 6 0 2 3 0 0 0 0
270 -2 6 0 2 7 0 0 0 0
271 -3 5 0 2 10 0 0 0 0
272 -1 6 0 2 5 0 0 0 0
273 0 7 0 2 10 0 0 0 0
274 0 8 0 2 9 0 0 0 0
275 0 6 0 2 15 0 0 0 0
276 0 5 0 2 11 0 0 0 0
277 -3 4 0 2 10 0 0 0 0
278 -1 4 0 2 9 0 0 0 0
279 0 4 0 2 7 0 0 0 0
280 1 4 0 2 14 0 0 0 0
281 1 5 0 2 14 0 0 0 0
282 1 6 0 2 13 0 0 0 0
283 1 8 0 2 5 0 0 0 0
284 -3 3 0 2 10 0 0 0 0
285 -1 3 0 2 10 0 0 0 0
286 -2 2 0 2 5 4 0 0 0
287 -3 2 0 2 3 0 0 0 0
288 -1 2 0 2 6 0 0 0 0
289 1 3 0 2 3 0 0 0 0
290 2 3 0 2 13 0 0 0 0
291 2 6 0 2 6 0 0 0 0
292 2 7 0 2 10 0 0 0 0
293 2 8 0 2 13 0 0 0 0
294 2 2 0 2 10 0 0 0 0
295 3 3 0 2 6 0 0 0 0
296 3 8 0 2 7 0 0 0 0
297 3 9 0 2 9 0 0 0 0
298 4 9 0 2 14 0 0 0 0
299 4 10 0 2 11 0 0 0 0
300 3 11 0 2 5 4 0 0 0
301 2 11 0 2 1 0 0 0 0
302 4 11 0 2 13 0 0 0 0
303 4 8 0 2 15 0 0 0 0
304 4 7 0 2 11 0 0 0 0
305 4 6 0 2 10 0 0 0 0
306 3 5 0 2 9 0 0 0 0
307 4 5 0 2 15 0 0 0 0
308 5 11 0 2 12 0 0 0 0
309 5 10 0 2 6 0 0 0 0
310 5 8 0 2 13 0 0 0 0
311 5 7 0 2 6 0 0 0 0
312 3 4 0 2 11 0 0 0 0
313 4 4 0 2 6 0 0 0 0
314 6 8 0 2 6 0 0 0 0
315 6 9 0 2 9 4 0 0 0
316 7 10 0 2 10 0 0 0 0
317 7 11 0 2 9 0 0 0 0
318 8 11 0 2 5 0 0 0 0
319 7 9 0 2 7 0 0 0 0
320 8 9 0 2 13 0 0 0 0
321 9 11 0 2 12 0 0 0 0
322 9 10 0 2 10 0 0 0 0
323 8 8 0 2 10 0 0 0 0
324 9 9 0 2 14 0 0 0 0
325 9 8 0 2 10 4 0 0 0
326 7 7 0 2 9 0 0 0 0
327 8 7 0 2 15 0 0 0 0
328 9 7 0 2 6 0 0 0 0
329 5 5 0 2 5 0 0 0 0
330 6 6 0 2 9 0 0 0 0
331 6 5 0 2 14 0 0 0 0
332 7 6 0 2 7 0 0 0 0
333 8 6 0 2 6 0 0 0 0
334 6 4 0 2 2 4 0 0 0
335 5 3 0 2 13 0 0 0 0
336 4 3 0 2 9 0 0 0 0
337 4 2 0 2 11 0 0 0 0
338 6 3 0 2 13 0 0 0 0
339 2 1 0 2 10 0 0 0 0
340 2 0 0 2 3 0 0 0 0
341 3 0 0 2 5 0 0 0 0
342 4 0 0 2 6 0 0 0 0
343 4 1 0 2 10 0 0 0 0
344 5 2 0 2 7 0 0 0 0
345 6 2 0 2 6 0 0 0 0
346 7 3 0 2 5 0 0 0 0
347 8 4 0 2 11 0 0 0 0
348 8 3 0 2 14 0 0 0 0
349 8 2 0 2 3 0 0 0 0
350 8 5 0 2 9 0 0 0 0
351 9 5 0 2 12 2 0 0 0
352 9 4 0 2 6 0 0 0 0
353 9 2 0 2 4 4 0 0 0
354 -3 5 0 0 9 0 0 0 0
