0 -5 2 0 0 1 0 0 0 0
1 -4 2 0 0 13 0 0 0 0
2 -3 2 0 0 13 0 0 0 0
3 -2 2 0 0 5 0 0 0 0
4 -1 2 0 0 12 0 0 0 0
5 0 2 0 0 9 4 0 0 0
6 1 2 0 0 12 0 0 0 0
7 2 2 0 0 9 0 0 0 0
8 3 2 0 0 5 0 0 0 0
9 4 2 0 0 12 0 0 0 0
10 -5 1 0 0 9 0 0 0 0
11 -4 1 0 0 6 0 0 0 0
12 -3 1 0 0 3 0 0 0 0
13 -2 1 0 0 12 0 0 0 0
14 -1 1 0 0 3 0 0 0 0
15 0 1 0 0 6 0 0 0 0
16 1 1 0 0 2 0 0 0 0
17 2 1 0 0 10 0 0 0 0
18 3 1 0 0 8 0 0 0 0
19 4 1 0 0 10 2 0 0 0
20 -5 0 0 0 10 4 0 0 0
21 -4 0 0 0 9 0 0 0 0
22 -3 0 0 0 5 0 0 0 0
23 -2 0 0 0 7 0 0 0 0
24 -1 0 0 0 12 0 0 0 0
25 0 0 0 0 9 0 0 0 0
26 1 0 0 0 13 0 0 0 0
27 2 0 0 0 14 0 0 0 0
28 3 0 0 0 3 0 0 0 0
29 4 0 0 0 6 0 0 0 0
30 -5 -1 0 0 10 0 0 0 0
31 -4 -1 0 0 3 0 0 0 0
32 -3 -1 0 0 5 0 0 0 0
33 -2 -1 0 0 12 0 0 0 0
34 -1 -1 0 0 3 0 0 0 0
35 0 -1 0 0 14 0 0 0 0
36 1 -1 0 0 10 0 0 0 0
37 2 -1 0 0 3 0 0 0 0
38 3 -1 0 0 5 0 0 0 0
39 4 -1 0 0 12 0 0 0 0
40 -5 -2 0 0 10 0 0 0 0
41 -4 -2 0 0 9 0 0 0 0
42 -3 -2 0 0 4 0 0 0 0
43 -2 -2 0 0 10 0 0 0 0
44 -1 -2 0 0 9 0 0 0 0
45 0 -2 0 0 6 0 0 0 0
46 1 -2 0 0 3 0 0 0 0
47 2 -2 0 0 5 0 0 0 0
48 3 -2 0 0 4 0 0 0 0
49 4 -2 0 0 10 0 0 0 0
50 -5 -3 0 0 11 0 0 0 0
51 -4 -3 0 0 6 0 0 0 0
52 -3 -3 0 0 9 0 0 0 0
53 -2 -3 0 0 6 0 0 0 0
54 -1 -3 0 0 3 0 0 0 0
55 0 -3 0 0 12 0 0 0 0
56 1 -3 0 0 9 0 0 0 0
57 2 -3 0 0 12 0 0 0 0
58 3 -3 0 0 9 0 0 0 0
59 4 -3 0 0 6 0 0 0 0
60 -5 -4 0 0 3 0 0 0 0
61 -4 -4 0 0 5 0 0 0 0
62 -3 -4 0 0 6 0 0 0 0
63 -2 -4 0 0 1 0 0 0 0
64 -1 -4 0 0 12 0 0 0 0
65 0 -4 0 0 3 0 0 0 0
66 1 -4 0 0 6 0 0 0 0
67 2 -4 0 0 2 0 0 0 0
68 3 -4 0 0 3 0 0 0 0
69 4 -4 0 0 12 0 0 0 0
70 -5 -5 0 0 8 0 0 0 0
71 -4 -5 0 0 9 0 0 0 0
72 -3 -5 0 0 5 0 0 0 0
73 -2 -5 0 0 12 0 0 0 0
74 -1 -5 0 0 10 0 0 0 0
75 0 -5 0 0 9 0 0 0 0
76 1 -5 0 0 12 0 0 0 0
77 2 -5 0 0 9 0 0 0 0
78 3 -5 0 0 4 0 0 0 0
79 4 -5 0 0 10 0 0 0 0
80 -5 -6 0 0 2 0 0 0 0
81 -4 -6 0 0 11 0 0 0 0
82 -3 -6 0 0 12 0 0 0 0
83 -2 -6 0 0 3 0 0 0 0
84 -1 -6 0 0 7 0 0 0 0
85 0 -6 0 0 6 0 0 0 0
86 1 -6 0 0 10 0 0 0 0
87 2 -6 0 0 3 0 0 0 0
88 3 -6 0 0 12 0 0 0 0
89 4 -6 0 0 10 0 0 0 0
90 -5 -7 0 0 9 0 0 0 0
91 -4 -7 0 0 14 0 0 0 0
92 -3 -7 0 0 3 0 0 0 0
93 -2 -7 0 0 12 0 0 0 0
94 -1 -7 0 0 1 0 0 0 0
95 0 -7 0 0 5 4 0 0 0
96 1 -7 0 0 6 0 0 0 0
97 2 -7 0 0 9 0 0 0 0
98 3 -7 0 0 14 0 0 0 0
99 4 -7 0 0 10 0 0 0 0
100 -5 -8 0 0 10 4 0 0 0
101 -4 -8 0 0 3 0 0 0 0
102 -3 -8 0 0 12 0 0 0 0
103 -2 -8 0 0 3 0 0 0 0
104 -1 -8 0 0 4 0 0 0 0
105 0 -8 0 0 9 0 0 0 0
106 1 -8 0 0 5 0 0 0 0
107 2 -8 0 0 6 0 0 0 0
108 3 -8 0 0 11 0 0 0 0
109 4 -8 0 0 14 4 0 0 0
110 -5 -9 0 0 10 0 0 0 0
111 -4 -9 0 0 8 0 0 0 0
112 -3 -9 0 0 3 0 0 0 0
113 -2 -9 0 0 5 0 0 0 0
114 -1 -9 0 0 12 0 0 0 0
115 0 -9 0 0 10 0 0 0 0
116 1 -9 0 0 9 0 0 0 0
117 2 -9 0 0 12 0 0 0 0
118 3 -9 0 0 2 0 0 0 0
119 4 -9 0 0 10 0 0 0 0
120 -5 -10 0 0 10 0 0 0 0
121 -4 -10 0 0 10 0 0 0 0
122 -3 -10 0 0 9 0 0 0 0
123 -2 -10 0 0 5 0 0 0 0
124 -1 -10 0 0 6 0 0 0 0
125 0 -10 0 0 2 0 0 0 0
126 1 -10 0 0 10 0 0 0 0
127 2 -10 0 0 3 0 0 0 0
128 3 -10 0 0 13 0 0 0 0
129 4 -10 0 0 6 0 0 0 0
130 -5 -11 0 0 3 0 0 0 0
131 -4 -11 0 0 14 0 0 0 0
132 -3 -11 0 0 3 0 0 0 0
133 -2 -11 0 0 5 0 0 0 0
134 -1 -11 0 0 5 0 0 0 0
135 0 -11 0 0 12 0 0 0 0
136 1 -11 0 0 3 0 0 0 0
137 2 -11 0 0 12 0 0 0 0
138 3 -11 0 0 10 0 0 0 0
139 4 -11 0 0 8 0 0 0 0
140 -5 -12 0 0 1 0 0 0 0
141 -4 -12 0 0 7 0 0 0 0
142 -3 -12 0 0 5 0 0 0 0
143 -2 -12 0 0 5 0 0 0 0
144 -1 -12 0 0 4 4 0 0 0
145 0 -12 0 0 3 1 0 0 0
146 1 -12 0 0 5 0 0 0 0
147 2 -12 0 0 6 0 0 0 0
148 3 -12 0 0 3 0 0 0 0
149 4 -12 0 0 6 0 0 0 0
